##########
алкен	алкен	NN:Masc:Sin:Nom
алкена	алкен	NN:Masc:Sin:R
алкен	алкен	NN:Masc:Sin:V
алкене	алкен	NN:Masc:Sin:P
алкеном	алкен	NN:Masc:Sin:T
алкену	алкен	NN:Masc:Sin:D
алкены	алкен	NN:Masc:PL:Nom
алкенах	алкен	NN:Masc:PL:P
алкенам	алкен	NN:Masc:PL:D
алкенами	алкен	NN:Masc:PL:T
алкенов	алкен	NN:Masc:PL:R
алкены	алкен	NN:Masc:PL:V
алкан	алкан	NN:Masc:Sin:Nom
алкана	алкан	NN:Masc:Sin:R
алкан	алкан	NN:Masc:Sin:V
алкане	алкан	NN:Masc:Sin:P
алканом	алкан	NN:Masc:Sin:T
алкану	алкан	NN:Masc:Sin:D
алканы	алкан	NN:Masc:PL:Nom
алканах	алкан	NN:Masc:PL:P
алканам	алкан	NN:Masc:PL:D
алканами	алкан	NN:Masc:PL:T
алканов	алкан	NN:Masc:PL:R
алканы	алкан	NN:Masc:PL:V
амин	амин	NN:Masc:Sin:Nom
амина	амин	NN:Masc:Sin:R
амин	амин	NN:Masc:Sin:V
амине	амин	NN:Masc:Sin:P
амином	амин	NN:Masc:Sin:T
амину	амин	NN:Masc:Sin:D
амины	амин	NN:Masc:PL:Nom
аминах	амин	NN:Masc:PL:P
аминам	амин	NN:Masc:PL:D
аминами	амин	NN:Masc:PL:T
аминов	амин	NN:Masc:PL:R
амины	амин	NN:Masc:PL:V
бург	бург	NN:Masc:Sin:Nom
бурга	бург	NN:Masc:Sin:R
бургу	бург	NN:Masc:Sin:D
бурге	бург	NN:Masc:Sin:P
бург	бург	NN:Masc:Sin:V
бургом	бург	NN:Masc:Sin:T
бургах	бург	NN:Masc:PL:P
бургам	бург	NN:Masc:PL:D
бургами	бург	NN:Masc:PL:T
бурги	бург	NN:Masc:PL:Nom
бургов	бург	NN:Masc:PL:R
бурги	бург	NN:Masc:PL:V
таро	таро	NN:Neut
осман	осман	NN:Masc:Sin:Nom
османа	осман	NN:Masc:Sin:R
османа	осман	NN:Masc:Sin:V
османах	осман	NN:Masc:PL:P
османам	осман	NN:Masc:PL:D
османами	осман	NN:Masc:PL:T
османе	осман	NN:Masc:Sin:P
османом	осман	NN:Masc:Sin:T
османов	осман	NN:Masc:PL:R
османов	осман	NN:Masc:PL:V
осману	осман	NN:Masc:Sin:D
османы	осман	NN:Masc:PL:Nom
ник	ник	NN:Masc:Sin:Nom
ника	ник	NN:Masc:Sin:R
нику	ник	NN:Masc:Sin:D
ника	ник	NN:Masc:Sin:V
ником	ник	NN:Masc:Sin:T
нике	ник	NN:Masc:Sin:P
ники	ник	NN:Masc:PL:Nom
ников	ник	NN:Masc:PL:R
никам	ник	NN:Masc:PL:D
ники	ник	NN:Masc:PL:V
никами	ник	NN:Masc:PL:T
никах	ник	NN:Masc:PL:P
паша	паша	NN:Masc:Sin:Nom
паши	паша	NN:Masc:Sin:R
паше	паша	NN:Masc:Sin:D
пашу	паша	NN:Masc:Sin:V
пашей	паша	NN:Masc:Sin:T
паше	паша	NN:Masc:Sin:P
паши	паша	NN:Masc:PL:Nom
пашей	паша	NN:Masc:PL:R
пашам	паша	NN:Masc:PL:D
паши	паша	NN:Masc:PL:V
пашами	паша	NN:Masc:PL:T
пашах	паша	NN:Masc:PL:P
цеце	цеце	NN:Fem:Sin
хадис	хадис	NN:Masc:Sin:Nom
хадиса	хадис	NN:Masc:Sin:R
хадис	хадис	NN:Masc:Sin:V
хадисах	хадис	NN:Masc:PL:P
хадисам	хадис	NN:Masc:PL:D
хадисами	хадис	NN:Masc:PL:T
хадисе	хадис	NN:Masc:Sin:P
хадисом	хадис	NN:Masc:Sin:T
хадисов	хадис	NN:Masc:PL:R
хадисы	хадис	NN:Masc:PL:V
хадису	хадис	NN:Masc:Sin:D
хадисы	хадис	NN:Masc:PL:Nom